BBBBBBBBBBBBBBBBBBBBBBBBBBBBBBBBBBBBBBBBBBBBBBBBBBBBBBBBBB
B________________________________________________________B
B________________________________________________________B
B________________________________________________________B
B________________________________________________________B
B________FFFF____________________________________________B
B_______FFFFFF___________________________________________B
B________FFFF____________________________________________B
B_______FFF______________________________________________B
B_________FFFF___________________________________________B
B__________FFFF__________________________________________B
B__________FFFFFF________________________________________B
B________FFFF____________________________________________B
B________________________________________________________B
B________________________________________________________B
B________________________________________________________B
B____________________________HHHH_HHHH___________________B
B____________________________H_______H___________________B
B____________________________H_______H___________________B
B____________________________H_______H___________________B
B____________________________H_______H___________________B
B____________________________H_______H___________________B
B____________________________HHHHHHHHH___________________B
B________________________________________________________B
B________________________________________________________B
B________________________________________________________B
B________________________________________________________B
B________________________________________________________B
B________________________________________________________B
B________________________________________________________B
B________________________________________________________B
B________________________________________________________B
B________________________________________________________B
B________________________________________________________B
B________________________________________________________B
B________________________________________________________B
B________________________________________________________B
B________________________________________________________B
B________________________________________________________B
B________________________________________________________B
B________________________________________________________B
B________________________________________________________B
B________________________________________________________B
B________________________________________________________B
B________________________________________________________B
B________________________________________________________B
BBBBBBBBBBBBBBBBBBBBBBBBBBBBBBBBBBBBBBBBBBBBBBBBBBBBBBBBBB